{
  "name": "zone_2",
  "dimension": [10, 13],
  "grid": [
    [0, 0, 0, 0, 0, 0, 0, 0, 0, 0],
    [2, 1, 1, 1, 1, 1, 0, 0, 0, 0],
    [1, 0, 0, 0, 0, 1, 0, 0, 0, 0],
    [0, 0, 0, 0, 0, 1, 0, 0, 0, 0],
    [0, 0, 0, 0, 1, 1, 1, 0, 0, 0],
    [0, 0, 0, 0, 1, 1, 1, 0, 0, 0],
    [0, 0, 0, 0, 0, 0, 1, 0, 0, 0],
    [0, 0, 0, 0, 0, 0, 1, 1, 0, 0],
    [0, 0, 0, 0, 0, 0, 1, 1, 1, 1],
    [0, 0, 0, 0, 0, 0, 0, 0, 0, 1],
    [0, 0, 0, 0, 0, 0, 0, 0, 0, 0],
    [0, 0, 0, 0, 0, 0, 0, 0, 0, 0],
    [0, 0, 0, 0, 0, 0, 0, 0, 0, 0]
  ],
  "objects": []
}

